#########################
#o.....................o#
#o......         ......o#
#.###### ### ### ######.#
  #    # #  M M# #    #. 
 .#    # ####### #    #. 
#.######    {    ######.#
#o.....................o#
#########################