#########################
#                       #
#                       #
# ###### ### ### ###### #
  #    # # M  M# #    #  
  #    # ####### #    #  
# ######    }    ###### #
# .....                 #
#########################